11111111111111111111111111111111111
10000000000000000000000000000000001
100000000000000000000000000C0000001
10111000011111000011111000111111101
10101000000000100000000100000000101
10001000000000100000000100000001001
1000100C00011100E00011100C000010001
10001000000111000000111000000100C01
10001000000000100000000100001000001
1000100000000C10000000C100010000001
10111110011111000011111000100000001
10000000000P00000000000000000000001
11111111111111111111111111111111111