1111111111111111111
100C000C00000C00C01
1011111111111111101
10111111111111111C1
1P1E0000C0000C00001
1111111111111111111